00000000010000000000000000000000000000000000000001
00000000010000000000000000000000000000000000000000
00000000010000000000000000000000000000000000000000
00000000010000000000000000000000000000000000000000
00000000010000000000000000000000000000000000000000
00000000010000000000000000000000000000000000000000
00000000010000000000000000000000000000000000000000
00000000010000000000000000000000000000000000000000
00000000010000000000000000000000000000000000000000
00000000010000000000000000000000000000000000000000
00000000010000000000000000000000000000000000000000
00000000010000000000000000000000000000000000000000
00000000010000000000000000000000000000000000000000
00111111110000000000000000000000000000000000000000
00000000010000000000000000000000000000000000000000
00000000010000000000000000000000000000000000000000
11111110010000000000000000000000000000000000000000
00000000010000000000000000000000000000000000000000
00000000010000000000000000000000000000000000000000
00111111110000000000000000000000000000000000000000
00000000111111100000000000000000000000000000000000
00000011111111100000000000000000000000000000000000
00011111111111100000000000000000000000000000000000
00111111111111100000000000000000000000000000000000
00111111111111100000000000000000000000000000000000
00111111111111100000000000000000000000000000000000
00111111111111100000000000000000000000000000000000
00111111111111100000000000000000000000000000000000
00111111111111100000000000000000000000000000000000
00111111111111100000000000000000000000000000000000
00111111111111100000000000000000000000000000000000
00000000000000000000000000000000000000000000000000
00000000000000000000000000000000000000000000000000
00000000000000000000000000000000000000000000000000
00000000000000000000000000000000000000000000000000
00000000000000000000000000000000000000000000000000
00000000000000000000000000000000000000000000000000
00000000000000000000000000000000000000000000000000
00000000000000000000000000000000000000000000000000
00000000000000000000000000000000000000000000000000
00000000000000000000000000000000000000000000000000
00000000000000000000000000000000000000000000000000
00000000000000000000000000000000000000000000000000
00000000000000000000000000000000000000000000000000
00000000000000000000000000000000000000000000000000
00000000000000000000000000000000000000000000000000
00000000000000000000000000000000000000000000000000
00000000000000000000000000000000000000000000000000
00000000000000000000000000000000000000000000000000
10000000000000000000000000000000000000000000000001
