00000000011000000000000000000000000000000000000001
00000000011000000000000000000000000000000000000000
00000000011000000000000000000000000000000000000000
00000000011000000000000000000000000000000000000000
00000000011000000000000000000000000000000000000000
00000000011000000000000000000000000000000000000000
00000000011000000000000000000000000000000000000000
00000000011000000000000000000000000000000000000000
00000000011000000000000000000000000000000000000000
00000000011000000000000000000000000000000000000000
00000000011000000000000000000000000000000000000000
00000000011000000000000000000000000000000000000000
00111111111000000000000000000000000000000000000000
00111111111000000000000000000000000000000000000000
00000000011000000000000000000000000000000000000000
11111110011000000000000000000000000000000000000000
11111110011000000000000000000000000000000000000000
00000000011000000000000000000000000000000000000000
00111111111000000000000000000000000000000000000000
00111111111000000000000000000000000000000000000000
00000000111111100000000000000000000000000000000000
00000011111111100000000000000000000000000000000000
00011111111111100000000000000000000000000000000000
00111111111111100000000000000000000000000000000000
00111111111111100000000000000000000000000000000000
00111111111111100000000000000000000000000000000000
00111111111111100000000000000000000000000000000000
00111111111111100000000000000000000000000000000000
00111111111111100000000000000000000000000000000000
00111111111111100000000000000000000000000000000000
00111111111111100000000000000000000000000000000000
00000000000000000000000000000000000000000000000000
00000000000000000000000000000000000000000000000000
00000000000000000000000000000000000000000000000000
00000000000000000000000000000000000000000000000000
00000000000000000000000000000000000000000000000000
00000000000000000000000000000000000000000000000000
00000000000000000000000000000000000000000000000000
00000000000000000000000000000000000000000000000000
00000000000000000000000000000000000000000000000000
00000000000000000000000000000000000000000000000000
00000000000000000000000000000000000000000000000000
00000000000000000000000000000000000000000000000000
00000000000000000000000000000000000000000000000000
00000000000000000000000000000000000000000000000000
00000000000000000000000000000000000000000000000000
00000000000000000000000000000000000000000000000000
00000000000000000000000000000000000000000000000000
00000000000000000000000000000000000000000000000000
10000000000000000000000000000000000000000000000001
